[
  {
    "level": 1,
    "difficulty": "Easy",
    "grid": [
      "#########",
      "#S......#",
      "#.#####.#",
      "#.#...#.#",
      "#.#.#.#.#",
      "#...#G..#",
      "#########"
    ]
  },
  {
    "level": 2,
    "difficulty": "Medium",
    "grid": [
        "################################",
        "#S.............................#",
        "#.############################.#",
        "#.#..........................#.#",
        "#.#.########################.#.#",
        "#.#..........................#.#",
        "###.##########################.#",
        "#..............................#",
        "#.#.##########################.#",
        "#.#..........................#.#",
        "#.#.########################.#.#",
        "#.#..........................#.#",
        "#.##############################",
        "#..............................#",
        "##############################G#",
        "################################"
    ]
  },
  {
    "level": 3,
    "difficulty": "Medium",
    "grid": [
      "################################",
      "#S.............................#",
      "##............................##",
      "#..........#####################",
      "#.#..........................#.#",
      "#..##########........###########",
      "#.############################.#",
      "#..............................#",
      "#..##########......##########..#",
      "##............................##",
      "#.#.........................G#.#",
      "#.############################.#",
      "################################"
    ]
  },
  {
    "level": 4,
    "difficulty": "Hard",
    "grid": [
      "################################",
      "#S.............................#",
      "#.###.###.###.###.###.###.####.#",
      "##...#...#...#...#...#...#...#.#",
      "#..#...#...#...#...#...#...#...#",
      "#.#############.###########.#.##",
      "#.#############.###########.##.#",
      "#..............................#",
      "###.########.#########.#########",
      "###........###.......###.....###",
      "####..........................##",
      "#############################G.#",
      "################################"
    ]
  },
  {
    "level": 5,
    "difficulty": "Hard",
    "grid": [
      "################################",
      "#S.............................#",
      "##############################.#",
      "#............................#.#",
      "#.##########################.#.#",
      "#.#........................#.#.#",
      "#.#.######################.#.#.#",
      "#.#.#....................#.#.#.#",
      "#.#.#.##################.#.#.#.#",
      "#.#.#.#...............G#.#.#.#.#",
      "#.#.#.#.################.#.#.#.#",
      "#.#.#.#..................#.#.#.#",
      "#.#.#.####################.#.#.#",
      "#.#.#......................#.#.#",
      "#.#.########################.#.#",
      "#.#..........................#.#" ,
      "#.############################.#",
      "#..............................#",
      "################################"
    ]
  }
]